0000000000000000000000000
0000000000000000000000000
0000000000000000000000000
0000000000000000000000000
0000000000000000000000000
0000000000000000000000000
0000000000000000000000000
0000000000000000011000000
0000000000000000010000000
0000000000000110010000000
0000000001100110010000003
1111111111111111111111111
1111111111111111111111111
0000000000000000000000000
0000000000000000000000000